# 1: open space
# 2: wall
# 3: player
# 4: Blinky
#
222222222222222222
211111114111111112
212211111111112212
212111111111111212
211111113111111112
212111111111111212
212211111111112212
211111111111111112
222222222222222222
