# 1: open space
# 2: wall
# 3: player
# 4: ghost house
# 5: power pellet
22222222222222222222
25111111114111111152
21221222222222212212
21221111111111112212
21111111111111111112
21111111111111112212
21221212222221212212
21111113111111111112
22222222222222222222