# 1: open space
# 2: wall
# 3: player
#
22222222222222222222222222
21111111111111111111111112
21221111111111111111111112
21111111111111111111111112
21221111111111111111111112
21211111111111111111111112
21212211111111111111111112
21111111111111111111111112
21221111111111111111111112
21221111111111111111111112
21111111111111111111111112
21221111111111111111111112
21121111111311111111111112
21121111111111111111111112
21121111111111111111111112
21221111111111111111111112
21111111111111111111111112
21111111111111111111111112
21111111111111111111111112
21111111111111111111111112
21111111111111111111111112
21211111111111111111111112
21211111111111111111111112
21211111111111111111111112
21211111111111111111111112
21222222111111111111111112
21111111111111111111111112
22222222222222222222222222
